%%%%%%%%%%%%%%%%%%%%%%%%%%%
%%%%%%%%%%%%%%%%%%%%%%%%%%%
%%%%%%%%%%%%%%%%%%%%%%%%%%%
%%%%%% %%%%%%%%%%%%%%%%%%%%
%%%%%% %%%%%%%%%%%%%%%%%%%%
%%%%%%%%%%%%%%%%%%%%%%%%%%%
%%%%%%%%%%%%%%%%%%%%%%%%%%%
%%%%     %    %%%%%%% %%%%%
%%%%     %    %% %%%%%%%%%%
%%%%     %    %%%%%%%%%%%%%
%%%%%%%%%%%%%%%%%%%%%%%%%%%
%%%%%%%%%%%%%%%%%%%%%%%%%%%
%%%%%%%%%%%%%%%%%%%%%%%%%%%
%%%%%%%%%%%%%%%%%%%%%%%%%%%
%%%%%  %%%%%%%%%%%%%%%%%%%%
%%%%% %%%%%%%%%%%%%%%%%%%%%
%%%%%  %%%%%%%%%%%%%%%%%%%%
%%%%%  %%%%%%%     %%%%%%%%
%%%%%..%%%%%%%     %%%%%%%%
%%%%%%%%%%%%%%%%%%%%%%%%%%%
%%%%%%%%%%%%%%%%%%%%%%%%%%%
%%%%%%%%%%%%%%%%%%%%%%%%%%%
#
%%%%%%%%%%%%%%%%%%%%%%%%%%%
%%%%%%%%%%%%%%%%%%%%%%%%%%%
%%%%%%%%%%%%%%%%%%%%%%%%%%%
%%%%P     %%%%%%%%%%%%%%%%%
%%%%%%%%%%%%%%%%%%%%%%%%%%%
%%%%%%%%%%%%%%%%%%%%%%%%%%%
%%%%%%%%%%%%%%%%%%%%%%%%%%%
%%%%%%%%%%%%    %%%%%%%%%%%
%%              %%%%%%%%%%%
%%              %%%%%%%%%%%
%%  %%%%%%%%%%%%%%%%%%%%%%%
%%  %%%%%%%%%%%%%%%%%%%%%%%
%%  %%%%%%%%%%%%%%%%%% %%%%
%%  %%%%%%%%%%%%%%%%%% %%%%
%%    %%%%%%%%%%%%%%%%%%%%%
%%    %%%%%%%%%%%%%%%%%%%%%
%%  %%%%%%%%%%%%%%%%%%%%%%%
%%  %%%%%%%%         %%%%%%
%%  %%%%%%%%         %%% %%
%%  %%%%%%%%%%%%%%%%%%%% %%
%%%%%%%%%%%%%%%%%%%%%%%%%%%
%%%%%%%%%%%%%%%%%%%%%%%%%%%
#
%%%%%%%%%%%%%%%%%%%%%%%%%%%
%%%%%%%%%%%%%%%%%%%%%%%%%%%
%%%%%%%%%%%%%%%%%%%%%%%%%%%
%%%%%%%%%%%%%%%%%%%%%%%%%%%
%%%%%%%%%%%%%%%%%%%%%%%%%%%
%%%%%%%%%%%%%%%%%%%%%%%%%%%
%%%%%%%%%%%%%%%%%%%%%%%%%%%
%%%%%%%%%%%%%%%%%%%%%%%%%%%
%%%%%%%%%%%%%%%%%%%%%%%%%%%
%%  %%%%%%%%%%%%%%%%%%%%%%%
%%  %%%%%%%%%%%%%%%%%%%%%%%
%%  %%%%%%%%%%%%%%%%%%%%%%%
%%  %%%%%%%%%%%%%%%%%%%%%%%
%%%%%%%%%%%%%%%%%%%%%%%%%%%
%%%%%%%%%%%%%%%%%%%%%%%%%%%
%%%%%%%%%%%%%%%%%%%%%%%%%%%
%%%%%%%%%%%%%%%%%%%%%%%%%%%
%%%%%%%%%%%%%%%%%%%%%%%%%%%
%%%%%%%%%%%%%%%%%%%%%%%%%%%
%%%%%%%%%%%%%%%%%%%%%%%%%%%
%%%%%%%%%%%%%%%%%%%%%%%%%%%
%%%%%%%%%%%%%%%%%%%%%%%%%%%
#
