%%%%%%%%%%%%%%%%%%%%%%%
%%%%%%%%%%%%%%%%%%%%%%%
%%%%  %%%%%%%%%%%%%%%%%
%%%%  %%%%%%%%%%%%%%%%%
%%%%  %%%%%%%..   %%%%%
%%%%  %%%%%%%%%%%%%%%%%
%%%%  %%%%%%%%%%%%%%%%%
%%%%      %%%%%%%%%%%%%
%%%%%%%%%%%%%%%%%%%%%%%
%%%%%%%%%%%%%%%%%%%%%%%
%%%%%%%%%%%%%%%%%%%%%%%
%%%%   %%% %%% %%%%%%%%
%%%%              %%%%%
%%%%   %%% %%%%%%%%%%%%
%%%%%%%%%%%%%%%%%%%%%%%
%%%%%%%%%%%%%%%%%%%%%%%
%%%%%%%%%%%%%%  %  %%%%
%%%%               %%%%
%%%%               %%%%
%%%%%%%%%%%%%%%%%%%%%%%
%%%%%%%%%%%%%%%%%%%%%%%
#
%%%%%%%%%%%%%%%%%%%%%%%
%%%%%%%%%%%%%%%%%%%%%%%
%%      %%%%%%%%%%%%%%%
%%      %%%%%%%     %%%
%%      %%%%%%%     %%%
%%      %%%%%%%     %%%
%%      %%%%%%%%%%%%%%%
%%      %%%%%%%%%%%%%%%
%%%%%%%%%%%%%%%%%%%%%%%
%%%%%%%%%%%%%%%%%%%%%%%
%%%%%%%%%%%%%%%%%%%%%%%
%%         %%% %%%  %%%
%% P       %%% %%%  %%%
%%         %%%%%%%%%%%%
%%%%%%%%%%%%%%%%%%%%%%%
%%%%%%%%%%%%%%%%%%%%%%%
%%%%%%%%%%%%%%       %%
%%                   %%
%%                   %%
%%%%%%%%%%%%%%%%%%%%%%%
%%%%%%%%%%%%%%%%%%%%%%%
#
%%%%%%%%%%%%%%%%%%%%%%%
%%%%%%%%%%%%%%%%%%%%%%%
%%%%%%%%%%%%%%%%%%%%%%%
%%%%%%%%%%%%%%%%%%%%%%%
%%      %%%%%%%%%%%%%%%
%%%%%%%%%%%%%%%%%%% %%%
%%%%%%%%%%%%%%%%%%% %%%
%%%%%%%%%%%%%%%%%%% %%%
%%%%%%%%%%%%%%%%%%% %%%
%%%%%%%%%%%%%%%%%%% %%%
%%%%%%%%%%%%%%%%%%% %%%
%%%%%%%%%%%%%%%%%%%%%%%
%%%%%%%%%%%%%%%%%%%%%%%
%%%%%%%%%%%%%%%%%%%%%%%
%%%%%%%%%%%% %%%%%%%%%%
%%%%%%%%%%%% %%%%%%%%%%
%%%%%%%%%%%%%%%%%%%%%%%
%%%%%%%%%%%%%%%%%%%%%%%
%%%%%%%%%%%%%%%%%%%%%%%
%%%%%%%%%%%%%%%%%%%%%%%
%%%%%%%%%%%%%%%%%%%%%%%
#
