%%%%%%%%%%%%%%%%%%%%%%%%%%%%%%%%%%%%%
%%%%%%%%%%%%%%%%%%%%%%%%%%%%%%%%%%%%%
%%%%%%%%%%%%%%%%%%%%%%%%%%  %    %%%%
%%%%%% %%%%%%%%%%%%%%%%%%%%%%%   %%%%
%%%%%% %%%%%%%%%%%%%%%%%%%% %    %%%%
%%%%%%   %         %%%%%%%%      %%%%
%%%%%% %%%%%%%%%%%%%%%%%%%%      %%%%
%%%%%%%%%%%%%%%%%%%%%%%%%%%      %%%%
%%%%%%%%%%%%%%%%%%%%%%%%%%%      %%%%
%%%%%%%%%%%%% %%%%%%%%%%%%%      %%%%
%%%%%  % %    %%%% %%%%%%%%%%%%%%%%%%
%%%%%%%%%%%%%%%%%%%%%%%%%%%%%%%%%%%%%
%%%%%%%%%%%%%%%%%%%%%%%%%%%%%%%%%%%%%
%%%%%%%%%%%%%%%%%%%%%%%%%%%%%%%%%%%%%
%%%%%  %%%%%%%%%%%%%%%%%%%%%%%%%%%%%%
%%%%% %%%%%%%%%%%%%%%%%%%%%%     %%%%
%%%%%  %%%%%%%%%%%%%%%%%%%%%%    %%%%
%%%%%  %%%           %%%%%%%     %%%%
%%%%%..%%%           %%%%%%%     %%%%
%%%%%%%%%%%%%%%%%%%%%%%%%%%%     %%%%
%%%%%%%%%%%%%%%%%%%%%%%%%%%%     %%%%
%%%%%%%%%%%%%%%%%%%%%%%%%%%%%%%%%%%%%
%%%%     %       %%%%%%%%%%%%%%%%%%%%
%%%%     %       %%%%%%%%%%%%%%%%%%%%
%%%%     %       %%%%%%%...%%%%%%%%%%
%%%%     %       %%%%%%%%%%%%%%%%%%%%
%%%%%%%%%%%%%%%%%%%%%%%%%%%%%%%%%%%%%
%%%%%%%%%%%%%%%%%%%%%%%%%%%%%%%%%%%%%
#
%%%%%%%%%%%%%%%%%%%%%%%%%%%%%%%%%%%%%
%%%%%%%%%%%%%%%%%%%%%%%%%%%%%%%%%%%%%
%%%%%%%%%%%%%%%%%%%%%%%%%%         %%
%%%%      %%%%%%%%%%%%%%%%%        %%
%%%%P      %%%%%%%%%%%%%%%%%       %%
%%%%       %%%%%%%%  %%%%%%%       %%
%%%%       %%%%%%%%  %%%%%%%       %%
%%%%%%%%%%%%%%%%%%%% %%%%%%%       %%
%%%%%%%%%%%%%%%%%%%% %%%%%%%       %%
%%%%%%%%%%%%%%%%%%%  %%%%%%%       %%
%%  %%%%%%%%%%%%%%%% %%%%%%%%%%%%%%%%
%%  %%%%%%%%%%%%%%%%%%%%%%%%%%%%%%%%%
%%  %%%%%%%%%%%%%%%%%% %%%%%%%%%%%%%%
%%  %%%%%%%%%%%%%%%%%%  %%%%%%%%%%%%%
%%    %%%%%%%%%%%%%%%% %%%%%%%%%%%%%%
%%    %%%%%%%%%%%%%%%% %%%%        %%
%%  %%%%%%%%%%%%%%%%%% %%%         %%
%%  %%%%%%%%           %%%         %%
%%  %%%%%%%%           %%%         %%
%%  %%%%%%%%%%%%%%%%%% %%%         %%
%%  %%%%%%%%%%%%%%%%%% %%%         %%
%%  %%%%%%%%%%%%%%%%%% %%%%%%%%%   %%
%%                 %%% %%%%%%%%%   %%
%%                 %%% %%%%%%%%%   %%
%%                 %%%  ...  %%%   %%
%%                 %%%%%%%%%%%%%   %%
%%%%%%%%%%%%%%%%%%%%%%%%%%%%%%%%%%%%%
%%%%%%%%%%%%%%%%%%%%%%%%%%%%%%%%%%%%%
#
%%%%%%%%%%%%%%%%%%%%%%%%%%%%%%%%%%%%%
%%%%%%%%%%%%%%%%%%%%%%%%%%%%%%%%%%%%%
%%%%%%%%%%%%%%%%%%%%%%%%%%%%%%%%%%%%%
%%%%%%%%%%%%%%%%%%%%%%%%%%%%%%%%%%%%%
%%%%%%%%%%%%%%%%%%%%%%%%%%%%       %%
%%%%%%%%%%%%%%%%%%%%%%%%%%%%       %%
%%%%%%%%%%%%%%%%%%%%%%%%%%%%       %%
%%%%%%%%%%%%%%%%%%%% %%%%%%%       %%
%%%%%%%%%%%%%%%%%%%% %%%%%%%%%%%%%%%%
%%%%%%%%%%%%%%%%%%%%%%%%%%%%%%%%%%%%%
%%%%%%%%%%%%%%%%%%%%%%%%%%%%%%%%%%%%%
%%%%%%%%%%%%%%%%%%%%%%%%%%%%%%%%%%%%%
%%%%%%%%%%%%%%%%%%%%%%%%%%%%%%%%%%%%%
%%%%%%%%%%%%%%%%%%%%%%%%%%%%%%%%%%%%%
%%%%%%%%%%%%%%%%%%%%%%%%%%%%%%%%%%%%%
%%%%%%%%%%%%%%%%%%%%%%%%%%%%%%%%%%%%%
%%%%%%%%%%%%%%%%%%%%%% %%%%%%%%%%%%%%
%%%%%%%%%%%%%%%%%%%%%% %%%%        %%
%%%%%%%%%%%%%%%%%%%%%%%%%%%        %%
%%%%%%%%%%%%%%%%%%%%%%%%%%%%%%%%   %%
%%  %%%%%%%%%%%%%%%%%% %%%%%%%%%   %%
%%  %%%%%%%%%%%%%%%%%% %%%%%%%%%   %%
%%%%%%%%%%%%%%%%%%%%%% %%%%%%%%%   %%
%%%%%%%%%%%%%%%%%%%%%%%%%%%%%%%%   %%
%%%%%%%%%%%%%%%%%%%%%%%%%%%%%%%%%%%%%
%%%%%%%%%%%%%%%%%%%%%%%%%%%%%%%%%%%%%
%%%%%%%%%%%%%%%%%%%%%%%%%%%%%%%%%%%%%
%%%%%%%%%%%%%%%%%%%%%%%%%%%%%%%%%%%%%
#
