%%%%%%%%%%%%%%%%%%%%%%%%%%%%%%%%%%%%%%%%%%%%%%%%%%%%%%%%%%%%%%%
%%%%%%%%%%%%%%%%%%%%%%%%%%%%%%%%%%%%%%%%%%%%%%%%%%%%%%%%%%%%%%%
%%%%%%%%%%%%%%%%%%%%%%%%%% %%%                           %%%%%%
%%%%%%%%%%%%%%%%%%%%%%%%%%%%%%%%%%%%%%%%%%%%%%%%%%     %%%%%%%%
%%%%%%%%%%     %%% %%%%%%%%%%%%%%%%%%%%%%%%%%%%%%%%%%  %%%%%%%%
%%%%%%%%%%     %%% %%%%%%%%%%%%%%%%%%%%%%%%%%%%%%%%%%  %%%%%%%%
%%%%%%%%%%                             %%%  %%%%%%%%%    %%%%%%
%%%%%%%%%%                             %%%  %%%%%%%%%    %%%%%%
%%%%%%%%%%                             %%%  %%%%%%%%%    %%%%%%
%%%%%%%%%%                             %%%  %%%%%%%%%    %%%%%%
%%%%%%%%%%     %%% %%%%%%%%%%%%%%%%%%%%%%% %%%%%%%%%%    %%%%%%
%%%%%%%%%%     %%% %%%%%%%%%%%%%%%%%%%%%%% %%%%%%%%%%    %%%%%%
%%%%%%%%%%     %%% %%%%%%%%%%%%%%%%%%%%%%% %%%%%%%%%%    %%%%%%
%%%%%%%%%%%%%%%%%%%%%%%%%% %%%%%  %%%%%%%   %%%%%%%%%    %%%%%%
%%%%%%%%%%%%%%%%%%%%%%%%%% %%%%%  %%%%%%%%  %%%%%%%%%    %%%%%%
%%%%%%%%%%%%%%%%%%%%%%%%%% %%%%%  %%%%%%%%  %%%%%%%%%    %%%%%%
%%%%%%                       %%%  %%%%%%%%  %%%%%%%%%    %%%%%%
%%%%%%                       %%%  %%%%%%%%  %%%%%%%%%    %%%%%%
%%%%%%                       %%%  %%%%%%%%  %%%%%%%%%    %%%%%%
%%%%%%                       %%%  %%%%%%%%  %%%%%%%%%    %%%%%%
%%%%%%                       %%%  %%%%%%%%  %%%%%%%%%    %%%%%%
%%%%%%%%%%%%%%%%%%%%%%%%%%%%%%%%%%%%%%%%%%%%%%%%%%%%%%%%%%%%%%%
%%%%%%%%%%%%%%%%%%%%%%%%%%%%%%%%%%%%%%%%%%%%%%%%%%%%%%%%%%%%%%%
%%%%%%%%%%%%%%%%%%%%%%%%%%%%%%%%%%%%%%%%%%%%%% %%%%%%%%%%%%%%%%
%%%%%%%%%%%%%%%%%%%%%%%%%%%%%%%%%%%%%%%%%%%%%% %%%%%%%%%%%%%%%%
%%%%%%%%%%%%%%%%%%%%%%%%%%%%%%%%%%%%%%%%%%%%%% %%%%%%%%%%%%%%%%
%%%%%%                             %%%%%%%%%%% %%%%%%%%%%%%%%%%
%%%%%%                             %%%%%%%%%%% %%%%%%%%%%%%%%%%
%%%%%%                             %%%%%%%%%%% %%%       %%%%%%
%%%%%%%%     %%%%%%%%%%%%%%%%%%%%%%%%%%%%%%%%% %%        %%%%%%
%%%%%%%%     %%%%%%%%%%%%%%%%%%%%%%%%%%%%%%%%% %%%       %%%%%%
%%%%%%%%     %%%%%%%%%%%%%%%%%%%%%%%%%%%%%%%%%%%%%%%%  %%%%%%%%
%%%%%%%%       %%%%%%%%%%%                %%%%%%%%%%%  %%%%%%%%
%%%%%%%%       %%%%%%%%%%%                %%%%%%%%%%%  %%%%%%%%
%%%%%%%%       %%%%%%%%%%%                %%%%%%%%%%%    %%%%%%
%%%%%%%%       %%%%%%%%%%%                %%%%%%%%%%%    %%%%%%
%%%%%%%%  .....%%%%%%%%%%%                %%%%%%%%%%%    %%%%%%
%%%%%%%% ......%%%%%%%%%%%                %%%%%%%%%%%    %%%%%%
%%%%%%%%.......%%%%%%%%%%%                %%%%%%%%%%%    %%%%%%
%%%%%%%%%%%%%%%%%%%%%%%%%%%%%%%%%%%%%%%%%%%%%%%%%%%%%    %%%%%%
%%%%%%%%%%%%%%%%%%%%%%%%%%%%%%%%%%%%%%%%%%%%%%%%%%%%%    %%%%%%
%%%%%%%%%%%%%%%%%%%%%%%%%%%%%%%%%%%%%%%%%%%%%%%%%%%%%    %%%%%%
%%%%%%                             %%%%%%%%%%%%%%%%%%    %%%%%%
%%%%%%                             %%%%%%%%%%%%%%%%%%%%%%%%%%%%
%%%%%%                             %%%%%%%%%%%%%%%%%%%%%%%%%%%%
%%%%%%                             %%%%%%%%%%%%%%%%%%%%%%%%%%%%
%%%%%%                             %%%%%%%%%%%         %%%%%%%%
%%%%%%                             %%%%%%%%%%%         %%%%%%%%
%%%%%%                             %%%%%%%%%%%.........%%%%%%%%
%%%%%%                             %%%%%%%%%%%.........%%%%%%%%
%%%%%%                             %%%%%%%%%%%.........%%%%%%%%
%%%%%%                             %%%%%%%%%%%.........%%%%%%%%
%%%%%%                             %%%%%%%%%%%.........%%%%%%%%
%%%%%%                             %%%%%%%%%%%         %%%%%%%%
%%%%%%                             %%%%%%%%%%%         %%%%%%%%
%%%%%%                             %%%%%%%%%%%%%%%%%%%%%%%%%%%%
%%%%%%                             %%%%%%%%%%%%%%%%%%%%%%%%%%%%
%%%%%%                             %%%%%%%%%%%%%%%%%%%%%%%%%%%%
%%%%%%                                                   %%%%%%
%%%%%%%%%%%%%%%%%%%%%%%%%%%%%%%%%%%%%%%%%%%%%%%%%%%%%%%%%%%%%%%
%%%%%%%%%%%%%%%%%%%%%%%%%%%%%%%%%%%%%%%%%%%%%%%%%%%%%%%%%%%%%%%
#
%%%%%%%%%%%%%%%%%%%%%%%%%%%%%%%%%%%%%%%%%%%%%%%%%%%%%%%%%%%%%%%
%%%%%%%%%%%%%%%%%%%%%%%%%%%%%%%%%%%%%%%%%%%%%%%%%%%%%%%%%%%%%%%
%%%%%%%%%%%%%%%%%%%%%%%%%%%%%%%%%%%%%%%%%%%%%%%%%%%%%%%%%%%%%%%
%%%%%%%%%%%%%%%%%%%%%%%%%%%%%%%%%%%%%%%%%%%%%%%%%%%%%%%%%%%%%%%
%%%%%%%%%%%%%%%%%%%%%%%%%%%%%%%%%%%%%%%%%%%%%%%%%%%%%      %%%%
%%%%%%%%%%%%%%%%%%%%%%%%%%%%%%%%%%%%%%%%%%%%%%%%%%%%%%%%   %%%%
%%%%%%%%             %%%%%%%%%%%%%%%%%%%%%%%%%%%%%%%%%%%   %%%%
%%%%%%%%             %%%%%%%%%%%%%%%%%%%%%%%%%%%%%%%%%%%   %%%%
%%%%%%%%P            %%%%%%%%%%%%%%%%%%% %%%%%%%%%%%%%%%   %%%%
%%%%%%%%             %%%%%%%%%%%%%%%%%%% %%%%%%%%%%%%%%%   %%%%
%%%%%%%%             %%%%%%%%%%%%%%%%%%% %%%%%%%%%%%%%%%   %%%%
%%%%%%%%%%%%%%%%%%%%%%%%%%%%%%%%%%%%%%%%%%%%%%%%%%%%%%%%   %%%%
%%%%%%%%%%%%%%%%%%%%%%%%%%%%%%%%%%%%%%%%%%%%%%%%%%%%%%%%   %%%%
%%%%%%%%%%%%%%%%%%%%%%%%%%%%%%%%%%%%%%%%%%%%%%%%%%%%%%%%   %%%%
%%%%%%%%%%%%%%%%%%%%%%%%%%%%%%%%%%%%%%%%%%%%%%%%%%%%%%%%   %%%%
%%%%%%%%%%%%%%%%%%%%%%%%       %%%%%%%%%%%%%%%%%%%%%%%%%   %%%%
%%%%%%%%%%%%%%%%%%%%%%%%       %%%%%%%%%%%%%%%%%%%%%%%%%   %%%%
%%%%%%%%%%%%%%%%%%%%%%%%       %%%%%%%%%%%%%%%%%%%%%%%%%   %%%%
%%%%                           %%%%%%%%%%%%%%%%%%%%%%%%%   %%%%
%%%%     %%%%%%%%%%%%%%%%%%%%%%%%%%%%%%%%%%%%%%%%%%%%%%%   %%%%
%%%%    %%%%%%%%%%%%%%%%%%%%%%%%%%%%%%%%%%%%%%%%%%%%%%%%   %%%%
%%%%   %%%%%%%%%%%%%%%%%%%%%%%%%%%%%%%%%%%%%%%%%%%%%%%%%   %%%%
%%%%   %%%%%%%%%%%%%%%%%%%%%%%%%%%%%%%%%%%%%%%%%%%%%%%%%   %%%%
%%%%   %%%%%%%%%%%%%%%%%%%%%%%%%%%%%%%%%%%%% %%%%%%%%%%%   %%%%
%%%%   %%%%%%%%%%%%%%%%%%%%%%%%%%%%%%%%%%%%% %%%%%%%%%%%   %%%%
%%%%   %%%%%%%%%%%%%%%%%%%%%%%%%%%%%%%%%%%%% %%%%%%%%%%%   %%%%
%%%%    %%%%%%%%%%%%%%%%%%%%%%%%%%%%%%%%%%%%    %%%%%%%%   %%%%
%%%%     %%%%%%%%%%%%%%%%%%%%%%%%%%%%%%%%%%%%%%%%%%%%%%%   %%%%
%%%%       %%%%%%%%%%%%%%%%%%%%%%%%%%%%%%%%%%%%%%%%%%%%%   %%%%
%%%%       %%%%%%%%%%%%%%%%%%%%%%%%%%%%%%%%%%%%%%%%%%%%%   %%%%
%%%%       %%%%%%%%%%%%%%%%%%%%%%%%%%%%%%%%%%%%%%%%%%%%%   %%%%
%%%%   %%%%%%%%%%%%%%%%%%%%%%%%%%%%%%%%%%%%%%%%%%%%%%%%%   %%%%
%%%%   %%%%%%%%%%%%%%%%%%%%%%%%%%%%%%%%%%%% %%%%%%%%       %%%%
%%%%   %%%%%%%%%%%%%%%%%%%%%%%%%%%%%%%%%%%  %%%%%%%%       %%%%
%%%%   %%%%%%%%%%%%%%%%%                    %%%%%%%%       %%%%
%%%%   %%%%%%%%%%%%%%%%%                    %%%%%%%%       %%%%
%%%%   %%%%%%%%%%%%%%%%%                    %%%%%%%        %%%%
%%%%   %%%%%%%%%%%%%%%%%%%%%%%%%%%%%%%%%%%  %%%%%%%        %%%%
%%%%   %%%%%%%%%%%%%%%%%%%%%%%%%%%%%%%%%%%% %%%%%%%        %%%%
%%%%   %%%%%%%%%%%%%%%%%%%%%%%%%%%%%%%%%%%%%%%%%%%%        %%%%
%%%%   %%%%%%%%%%%%%%%%%%%%%%%%%%%%%%%%%%%%%%%%%%%%        %%%%
%%%%   %%%%%%%%%%%%%%%%%%%%%%%%%%%%%%%%%%%%%%%%%%%%%%%%%%%%%%%%
%%%%    %%%%%%%%%%%%%%%%%%%%%%%%%%%%%%%%%%%%%%%%%%%%%%%%%%%%%%%
%%%%     %%%%%%%%%%%%%%%%%%%%%%%%%%%%%%%%%%%%%%%%%%%%%%%%%%%%%%
%%%%                                 %%%%%%%%%%%%%%%%%%%%%%%%%%
%%%%                                 %%%%%%%%%%%%%%%%%%%%%%%%%%
%%%%                                 %%%%%%% %%%%%%%%%%%%%%%%%%
%%%%                                 %%%%%%%  %%%%%%%%%%%%%%%%%
%%%%                                 %%%%%%%    .....    %%%%%%
%%%%                                 %%%%%%%   .......   %%%%%%
%%%%                                 %%%%%%%   .......   %%%%%%
%%%%                                 %%%%%%%   .......   %%%%%%
%%%%                                 %%%%%%%    .....    %%%%%%
%%%%                                 %%%%%%%%%%%%%%%%%%%%%%%%%%
%%%%                                 %%%%%%%%%%%%%%%%%%%%%%%%%%
%%%%                                 %%%%%%%%%%%%%%%%%%%%%%%%%%
%%%%                                 %%%%%%%%%%%%%%%%%%%%%%%%%%
%%%%%%%%%%%%%%%%%%%%%%%%%%%%%%%%%%%%%%%%%%%%%%%%%%%%%%%%%%%%%%%
%%%%%%%%%%%%%%%%%%%%%%%%%%%%%%%%%%%%%%%%%%%%%%%%%%%%%%%%%%%%%%%
%%%%%%%%%%%%%%%%%%%%%%%%%%%%%%%%%%%%%%%%%%%%%%%%%%%%%%%%%%%%%%%
%%%%%%%%%%%%%%%%%%%%%%%%%%%%%%%%%%%%%%%%%%%%%%%%%%%%%%%%%%%%%%%
#
%%%%%%%%%%%%%%%%%%%%%%%%%%%%%%%%%%%%%%%%%%%%%%%%%%%%%%%%%%%%%%%
%%%%%%%%%%%%%%%%%%%%%%%%%%%%%%%%%%%%%%%%%%%%%%%%%%%%%%%%%%%%%%%
%%%%%%%%%%%%%%%%%%%%%%%%%%%%%%%%%%%%%%%%%%%%%%%%%%%%%%%%%%%%%%%
%%%%%%%%%%%%%%%%%%%%%%%%%%%%%%%%%%%%%%%%%%%%%%%%%%%%%%%%%%%%%%%
%%%%%%%%%%%%%%%%%%%%%%%%%%%%%%%%%%%%%%%%%%%%%%%%%%%%%%%%%%%%%%%
%%%%%%%%%%%%%%%%%%%%%%%%%%%%%%%%%%%%%%%%%%%%%%%%%%%%%%%%%%%%%%%
%%%%%%%%%%%%%%%%%%%%%%%%%%%%%%%%%%%%%%%%%%%%%%%%%%%%%%       %%
%%%%%%%%%%%%%%%%%%%%%%%%%%%%%%%%%%%%%%%%%%%%%%%%%%%%%%       %%
%%%%%%%%%%%%%%%%%%%%%%%%%%%%%%%%%%%%%%%%%%%%%%%%%%%%%%       %%
%%%%%%%%%%%%%%%%%%%%%%%%%%%%%%%%%%%%%%%%%%%%%%%%%%%%%%       %%
%% %%%%%%%%%%%%%%%%%%% %%%%%%%%%%%%%    %% %%%%%%%%%%%       %%
%% %%%%%%%%%%%%%%%%%%% %%%%%%%%%%%%%%%%%%% %%%%%%%%%%%       %%
%% %%%%%%%%%%%%%%%%%%% %%%%%%%%%%%%%%%%%%% %%%%%%%%%%%       %%
%% %%%%%%%%%%%%%%%%%%% %%%%%%%%%%%%%%%%%%% %%%%%%%%%%%       %%
%%%%%%%%%%%%%%%%%%%%%%%%%%%%%%%%%%%%%%%%%% %%%%%%%%%%%       %%
%%%%%%%%%%%%%%%%%%%%%%%%%%%%%%%%%%%%%%%%%% %%%%%%%%%%%       %%
%% %%%%%%%%%%%%%%%%%%%%%%%%%%%%%%%%%%%%%%% %%%%%%%%%%%       %%
%% %%%%%%%%%%%%%%%%%%%%%%%%%%%%%%%%%%%%%%% %%%%%%%%%%%       %%
%%%%%%%%%%%%%%%%%%%%%%%%%%%%%%%%%%%%%%%%%% %%%%%%%%%%%       %%
%%%%%%%%%%%%%%%%%%%%%%%%%%%%%%%%%%%%%%%%%% %%%%%%%%%%%       %%
%%       %%%%%%%%%%%%%%%%%%%%%%%%%%%%%%%%% %%%%%%%%%%%       %%
%%       %%%%%%%%%%%%%%%%%%%%%%%%%%%%%%%%% %%%%%%%%%%%       %%
%%       %%%%%%%%%%%%%%%%%%%%%%%%%%%%%%%%% %%%%%%%%%%%       %%
%%       %%%%%%%%%%%%%%%%%%%%%%%%%%%%%%%%% %% %%%  %%%       %%
%%       %%%%%%%%%%%%%%%%%%%%%%%%%%%%%%%%% %% %%   %%%       %%
%%       %%%%%%%%%%%%%%%%%%%%%%%%%%%%%%%%% %%%%%%%%%%%       %%
%%%%%%%%%%%%%%%%%%%%%%%%%%%%%%%%%%%%%%%%%%%%%%%%%%%%%%       %%
%%%%%%%%%%%%%%%%%%%%%%%%%%%%%%%%%%%%%%%%%%%%%%%%%%%%%%       %%
%%       %%%%%%%%%%%%%%%%%%%%%%%%%%%%%%%%%    %%%  %%%       %%
%%       %%%%%%%%%%%%%%%%%%%%%%%%%%%%%%%%%    %%%  %%%       %%
%%%%%%%%%%%%%%%%%%%%%%%%%%%%%%%%%%%%%%%%%%%%%%%%%%%%%%       %%
%%       %%        %%%%%%%%%%%%%%%%%%%%%%%    %%%%%%%%       %%
%%       %%   .    %%%%%%%%%%%%%%%%%%%%%%%    %%%   %%       %%
%%%%%%%%%%%%%%%%%%%%%%%%%%%%%%%%%%%%%%%%%%    %%%   %%       %%
%%%%%%%%%%%%%%%%%%%%%%%%%%%%%%%%%%%%%%%%%%    %%%   %%       %%
%%       %%%%%%%%%%%%%%%%%%%%%%%%%%%%%%%%%    %%%%%%%%       %%
%%%%%%%%%%%%%%%%%%%%%%%%%%%%%%%%%%%%%%%%%%%%%%%%%%%%%%       %%
%%%%%%%%%%%%%%%%%%%%%%%%%%%%%%%%%%%%%%%%%%%%%%%%%%%%%%       %%
%%       %%%%%%%%%%%%%%%%%%%%%%%%%%%%%%%%%    %%%            %%
%%       %%%%%%%%%%%%%%%%%%%%%%%%%%%%%%%%%    %%%%%%%%%%%%%%%%%
%%       %%%%%%%%%%%%%%%%%%%%%%%%%%%%%%%%%    %%%%%%%%%%%%%%%%%
%%       %%%%%%%%%%%%%%%%%%%%%%%%%%%%%%%%%    %%%%%%%%%%%%%%%%%
%%       %%%%%%%%%%%%%%%%%%%%%%%%%%%%%%%%%    %%%%%%%%%%%%%%%%%
%%       %%%%%%%%%%%%%%%%%%%%%%%%%%%%%%%%%    %%%%%%%%%%%%%%%%%
%%%%%%%%%%%%%%%%%%%%%%%%%%%%%%%%%%%%%%%%%%    %%%%%%%%%%%%%%%%%
%%%%%%%%%%%%%%%%%%%%%%%%%%%%%%%%%%%%%%%%%%    %%%%%%%%%%%%%%%%%
%%                                     %%%    %%%%%%%%%%%%%%%%%
%%                                     %%%    %%%%%%%%%%%%%%%%%
%%                                     %%%    %%%%%%%%%%%%%%%%%
%%                                     %%%    %%%%%%%%%%%%%%%%%
%%                                     %%%      .....      %%%%
%%                                     %%%%%%%%%%%%%%%%%%%%%%%%
%%                                     %%%%%%%%%%%%%%%%%%%%%%%%
%%                                     %%%%%%%%%%%%%%%%%%%%%%%%
%%                                     %%%%%%%%%%%%%%%%%%%%%%%%
%%%%%%%%%%%%%%%%%%%%%%%%%%%%%%%%%%%%%%%%%%%%%%%%%%%%%%%%%%%%%%%
%%%%%%%%%%%%%%%%%%%%%%%%%%%%%%%%%%%%%%%%%%%%%%%%%%%%%%%%%%%%%%%
%%%%%%%%%%%%%%%%%%%%%%%%%%%%%%%%%%%%%%%%%%%%%%%%%%%%%%%%%%%%%%%
%%%%%%%%%%%%%%%%%%%%%%%%%%%%%%%%%%%%%%%%%%%%%%%%%%%%%%%%%%%%%%%
%%%%%%%%%%%%%%%%%%%%%%%%%%%%%%%%%%%%%%%%%%%%%%%%%%%%%%%%%%%%%%%
%%%%%%%%%%%%%%%%%%%%%%%%%%%%%%%%%%%%%%%%%%%%%%%%%%%%%%%%%%%%%%%
#
