%%%%%%%%%%%%%%%%%%%%%%%%%%%%%%%%%%%%%%%%%%%%%%%%%%%%%%%%%%%%%%%%%%%%%%%%%
%%%%%%%%%%%%%%%%%%%%%%%%%%%%%%%%%%%%%%%%%%%%%%%%%%%%%%%%%%%%%%%%%%%%%%%%%
%%%%%%%%%%%%%%%%%%%%%%%%%% %%% %             %                     %%%%%%
%%%%%%%%%%%%%%%%%%%%%%%%%% %%% %             %                     %%%%%%
%%%%%%%%%%     %%   %%%%%      %             %                     %%%%%%
%%%%%%%%%%     %%% %%%%%%%%%%%%%%%%%%%%%%%%%%%%%%%     %%%         %%%%%%
%%%%%%%%%%     %%% %%%%%%%%%%%%%%%%%%%%%%%%%%%%%%%%%%  %%%         %%%%%%
%%%%%%%%%%     %%% %%%%%%%%%%%%%%%%%%%%%%%%%%%%%%%%%%  %%%         %%%%%%
%%%%%%%%%%                     %       %%%  %%%%%%%%%              %%%%%%
%%%%%%%%%%                     %       %%%  %%%%%%%%%              %%%%%%
%%%%%%%%%%                     %       %%%  %%%%%%%%%              %%%%%%
%%%%%%%%%%                     %       %%%  %%%%%%%%%              %%%%%%
%%%%%%%%%%     %%% %%%%%%%%%%%%%%%%%%%%%%%  %%%%%%%%%              %%%%%%
%%%%%%%%%%     %%% %%%%%%%%%%%%%%%%%%%%%%%  %%%%%%%%%              %%%%%%
%%%%%%%%%%     %%% %%%%%%%%%%%%%%%%%%%%%%%  %%%%%%%%%              %%%%%%
%%%%%%%%%%%%%%%%%%%%%%%%%% %%%%%%%%%%  %%%  %%%%%%%%%              %%%%%%
%%%%%%%%%%%%%%%%%%%%%%%%%% %%%%%%%%%%  %%%  %%%%%%%%%              %%%%%%
%%%%%%%%%%%%%%%%%%%%%%%%%% %%%%%%%%%%%%%%%  %%%%%%%%%              %%%%%%
%%%%%%%%     %%%             %%%%%%%%%%%%%  %%%%%%%%%              %%%%%%
%%%%%%%%     %%%             %%%%%   %%%%%  %%%%%%%%%              %%%%%%
%%%%%%%%                       %%%     %%%  %%%%%%%%%              %%%%%%
%%%%%%%%          .........    %%      %%%  %%%%%%%%%%%%%%%%%%%%%%%%%%%%%
%%%%%%%%         ...........   %%%     %%%  %%%%%%%%%%%%%%%%%%%%%%%%%%%%%
%%%%%%%%%%%%%%%%%%%%%%%%%%%%%%%%%%%%%%%%%%%%%% %%%%%%%%%%%%%%%%%%%%%%%%%%
%%%%%%%%%%%%%%%%%%%%%%%%%%%%%%%%%%%%%%%%%%%%%%            .......%%%%%%%%
%%%%%%%%%%%%%%%%%%%%%%%%%%%%%%%%%%%%%%%%%%%%%%%%%%%%%%%%%%%%%%%%%%%%%%%%%
%%%%%%                         %   %%%%%%%%%%%%%%%%%%%%%%%%%%%%%%%%%%%%%%
%%%%%%                         %   %%%%%%%%%%%%%%%%%%%%%%%%%%%%%%%%%%%%%%
%%%%%%                         %   %%%%%%%%%%%%%                   %%%%%%
%%%%%%%%     %%%%%%%%%%%%%%%%%%%%%%%%%%%%%%%%%%                    %%%%%%
%%%%%%%%     %%%%%%%%%%%%%%%%%%%%%%%%%%%%%%%%%%%                   %%%%%%
%%%%%%%%     %%%%%%%%%%%%%%%%%%%%%%%%%%%%%%%%%%%%%%%%%%%           %%%%%%
%%%%%%%%       %%%             %           %%%%%%%%%%%%%           %%%%%%
%%%%%%%%       %%%             %           %%%%%%%%%%%%%           %%%%%%
%%%%%%%%       %%%             %           %%%%%%%%%%%             %%%%%%
%%%%%%%%       %%              %           %%%%%%%%%%%             %%%%%%
%%%%%%%%  .....%%%.            %           %%%%%%%%%%%             %%%%%%
%%%%%%%% ......%%%..           %           %%%%%%%%%%%             %%%%%%
%%%%%%%%.......%%%...          %           %%%%%%%%%%%             %%%%%%
%%%%%%%%%%%%%%%%%%%%%%%%%%%%%%%%%%%%%%%%%%%%%%%%%%%%%%             %%%%%%
%%%%%%%%%%%%%%%%%%%%%%%%%%%%%%%%%%%%%%%%%%%%%%%%%%%%%%             %%%%%%
%%%%%%%%%%%%%%%%%%%%%%%%%%%%%%%%%%%%%%%%%%%%%%%%%%%%%%             %%%%%%
%%%%%%                         %   %%%%%%%%%%%%%%%%%%%             %%%%%%
%%%%%%                         %   %%%%%%%%%%%%%%%%%%%%%%%%%%%%%%% %%%%%%
%%%%%%                         %   %%%%%%%%%%%%%%%%%%%%%%%%%%%%%%% %%%%%%
%%%%%%                         %   %%%%%%%%%%%%%%%%%%%%%%%%%%%%%%% %%%%%%
%%%%%%                         %   %%%%%%%%%%%         %%%%%%%%%%% %%%%%%
%%%%%%                         %   %%%%%%%%%%%         %%%%%%%%%%% %%%%%%
%%%%%%                         %   %%%%%%%%%%%.........%%%%%%%%%%% %%%%%%
%%%%%%                         %   %%%%%%%%%%%.........%%%%%%%%%%% %%%%%%
%%%%%%                         %   %%%%%%%%%%%.........%%%%%%%%%%% %%%%%%
%%%%%%                         %   %%%%%%%%%%%%%%%%%%%%%%%%%%%%%%% %%%%%%
%%%%%%                         %   %%%%%%%%%%%%%%%%%%%%%%%%%%%%%%% %%%%%%
%%%%%%%%%%%%%%%%%%%%%%%%%%%%%%%%%%%%%%%%%%%%%%%%%%%%%%%%%%%%%%%%%%%%%%%%%
%%%%%%%%%%%%%%%%%%%%%%%%%%%%%%%%%%%%%%%%%%%%%%%%%%%%%%%%%%%%%%%%%%%%%%%%%
#
%%%%%%%%%%%%%%%%%%%%%%%%%%%%%%%%%%%%%%%%%%%%%%%%%%%%%%%%%%%%%%%%%%%%%%%%%
%%%%%%%%%%%%%%%%%%%%%%%%%%%%%%%%%%%%%%%%%%%%%%%%%%%%%%%%%%%%%%%%%%%%%%%%%
%%%%%%%%%%%%%%%%%%%%%%%%%%%%%%%%%%%%%%%%%%%%%%%%%%%%%%%%%%%%%%%%%%%%%%%%%
%%%%%%%%%%%%%%%%%%%%%%%%%%%%%%%%%%%%%%%%%%%%%%%%%%%%%%%%%%%%%%%%%%%%%%%%%
%%%%%%%%%%%%%%%%%%%%%%%%%%%%%%%%%%%%%%%%%%%%%%%%%%%%                 %%%%
%%%%%%%%%%%%%%%%%%%%%%%%%%%%%%%%%%%%%%%%%%%%%%%%%%%%                 %%%%
%%%%%%%%            %%%%%%%%%%%%%%%%%%%%%%%%%%%%%%%%%                %%%%
%%%%%%%%             %%%%%%%%%%%%%%%%%%%%%%%%%%%%%%%%%%%             %%%%
%%%%%%%%P            %%%%%%%%%%%%%%%%%%%%%%%%%%%%%%%%%%%             %%%%
%%%%%%%%             %%%%%%%%%%%%%%%%%%%%%%%%%%%%%%%%%%%             %%%%
%%%%%%%%             %%%%%%%%%%%%%%%     %%%%%%%%%%%%%%%             %%%%
%%%%%%%%             %%%%%%%%%%%%%%%%    %%%%%%%%%%%%%%%             %%%%
%%%%%%%%             %%%%%%%%%%%%%%%%%   %%%%%%%%%%%%%%%             %%%%
%%%%%%%%%%%%%%%%%%%%%%%%%%%%%%%%%%%%%%   %%%%%%%%%%%%%%%             %%%%
%%%%%%%%%%%%%%%%%%%%%%%%%%%%%%%%%%%%%%%% %%%%%%%%%%%%%%%             %%%%
%%%%%%%%%%%%%%%%%%%%%%%%%%%%%%%%%%%%%%%% %%%%%%%%%%%%%%%             %%%%
%%%%%%%%%%%%%%%%%%%%%%%%%%%%%%%%%%%%%%%% %%%%%%%%%%%%%%%             %%%%
%%%%%%%%%%%%%%%%%%%%%%%%%%%%%%%%%%%%%%%% %%%%%%%%%%%%%%%             %%%%
%%%%%%%%%%%%%%%%%%%%%%%%%%%%%%%%%%%%%    %%%%%%%%%%%%%%%             %%%%
%%%%%%%%%%%%%%%%%%%%%%%%%%%%%%%%%%%%%%%% %%%%%%%%%%%%%%%%%%%%%%%%%%%%%%%%
%%%%   %%%%%%%%%%%%%%%%%%%%%%%%%%%%%%%%% %%%%%%%%%%%%%%%%%%%%%%%%%%%%%%%%
%%%%   %%%%%%%%%%%%%%%%%%%%%%%%%%%%%%%%%%%%%%%%%%%%%%%%%%%%%%%%%%%%%%%%%%
%%%%   %%%%%%%%%%%%%%%%%%%%%%%%%%%%%%%%%%%% %%%%%%%%%%%%%%%%%%%%%%%%%%%%%
%%%%   %%%%%%%%%%%%%%%%%%%%%%%%%%%%%%%%%%%%% %%%%%%%%%%%%%%%%%%%%%%%%%%%%
%%%%   %%%%%%%%%%%%%%%%%%%%%%%%%%%%%%%%%%%%% %%%%%%%%%%%%%%%%%%%%%%%%%%%%
%%%%   %%%%%%%%%%%%%%%%%%%%%%%%%%%%%%%%%%%%% %%%%%%%%%%%%%%%%%%%%%%%%%%%%
%%%%    %%%%%%%%%%%%%%%%%%%%%%%%%%%%%%%%%%%%   %%%%%%%%%%%%%%%%%%%%%%%%%%
%%%%     %%%%%%%%%%%%%%%%%%%%%%%%%%%%%%%%%%% %%%%%%%%%%%%%%%%%%%%%%%%%%%%
%%%%       %%%%%%%%%%%%%%%%%%%%%%%%%%%%%%%%% %%%%%%%%%%%%%%%%%%%%%%%%%%%%
%%%%       %%%%%%%%%%%%%%%%%%%%%%%%%%%%%%%%% %%%%%%%%%%%%%%%%%%%%%%%%%%%%
%%%%       %%%%%%%%%%%%%%%%%%%%%%%%%%%%%%%%% %%%%%%%%%               %%%%
%%%%   %%%%%%%%%%%%%%%%%%%%%%%%%%%%%%%%%%%%% %%%%%%%%%               %%%%
%%%%   %%%%%%%%%%%%%%%%%%%%%%%%%%%%%%%%%%%%  %%%%%%%                 %%%%
%%%%   %%%%%%%%%%%%%%%%%%%%%%%%%%%%%%%%%%%   %%%%%%%                 %%%%
%%%%   %%%%%%%%%%%%%%%%%                     %%%%%%%                 %%%%
%%%%   %%%%%%%%%%%%%%%%%                     %%%%%%%                 %%%%
%%%%   %%%%%%%%%%%%%%%%%                     %%%%%%%                 %%%%
%%%%   %%%%%%%%%%%%%%%%%%%%%%%%%%%%%%%%%%%   %%%%%%%                 %%%%
%%%%   %%%%%%%%%%%%%%%%%%%%%%%%%%%%%%%%%%%%  %%%%%%%                 %%%%
%%%%   %%%%%%%%%%%%%%%%%%%%%%%%%%%%%%%%%%%%% %%%%%%%                 %%%%
%%%%   %%%%%%%%%%%%%%%%%%%%%%%%%%%%%%%%%%%%% %%%%%%%                 %%%%
%%%%   %%%%%%%%%%%%%%%%%%%%%%%%%%%%%%%%%%%%% %%%%%%%%%%%%%%%%%       %%%%
%%%%    %%%%%%%%%%%%%%%%%%%%%%%%%%%%%%%%%%%% %%%%%%%%%%%%%%%%%%      %%%%
%%%%     %%%%%%%%%%%%%%%%%%%%%%%%%%%%%%%%%%% %%%%%%%%%%%%%%%%%%%     %%%%
%%%%                                 %%%%%%% %%%%%%%%%%%%%%%%%%%     %%%%
%%%%                                 %%%%%%% %%%%%%%%%%%%%%%%%%%     %%%%
%%%%                                 %%%%%%%  %%%%%%%%%%%%%%%%%%     %%%%
%%%%                                 %%%%%%%   %%%%%%%%%%%%%%%%%     %%%%
%%%%                                 %%%%%%%    .....    %%%%%%%     %%%%
%%%%                                 %%%%%%%%%%%%%%%%%%%%%%%%%%%     %%%%
%%%%                                 %%%%%%%%%%%%%%%%%%%%%%%%%%%     %%%%
%%%%%%%%%%%%%%%%%%%%%%%%%%%%%%%%%%%%%%%%%%%%%%%%%%%%%%%%%%%%%%%%%%%%%%%%%
%%%%%%%%%%%%%%%%%%%%%%%%%%%%%%%%%%%%%%%%%%%%%%%%%%%%%%%%%%%%%%%%%%%%%%%%%
%%%%%%%%%%%%%%%%%%%%%%%%%%%%%%%%%%%%%%%%%%%%%%%%%%%%%%%%%%%%%%%%%%%%%%%%%
%%%%%%%%%%%%%%%%%%%%%%%%%%%%%%%%%%%%%%%%%%%%%%%%%%%%%%%%%%%%%%%%%%%%%%%%%
#
%%%%%%%%%%%%%%%%%%%%%%%%%%%%%%%%%%%%%%%%%%%%%%%%%%%%%%%%%%%%%%%%%%%%%%%%%
%%%%%%%%%%%%%%%%%%%%%%%%%%%%%%%%%%%%%%%%%%%%%%%%%%%%%%%%%%%%%%%%%%%%%%%%%
%%%%%%%%%%%%%%%%%%%%%%%%%%%%%%%%%%%%%%%%%%%%%%%%%%%%%%%%%%%%%%%%%%%%%%%%%
%%%%%%%%%%%%%%%%%%%%%%%%%%%%%%%%%%%%%%%%%%%%%%%%%%%%%%%%%%%%%%%%%%%%%%%%%
%%%%%%%%%%%%%%%%%%%%%%%%%%%%%%%%%%%%%%%%%%%%%%%%%%%%%%%%%%%%%%%%%%%%%%%%%
%%%%%%%%%%%%%%%%%%%%%%%%%%%%%%%%%%%%%%%%%%%%%%%%%%%%%%%%%%%%%%%%%%%%%%%%%
%%%%%%%%%%%%%%%%%%%%%%%%%%%%%%%%%%%%%%%%%%%%%%%%%%%%%%                 %%
%% %%%%%%%%%%%%%%%%%%%%%%%%%%%%%%%%%%%%%%%%%%%%%%%%%%%                 %%
%% %%%             %%% %%%%%%%%%%%%%%%%%%%%%%%%%%%%%%%                 %%
%%%%%%%%%%%%%%%%%%%%%%%%%%%%%%%%%%%%%%%%%%%%%%%%%%%%%%                 %%
%%%%%%%%%%%%%%%%%%%%%%%%%%%%%%%%%%%%%%%%%%%%%%%%%%%%%%                 %%
%%%%%%%%%%%%%%%%%%%%%%%%%%%%%%%%%%%%%%%%%%%%%%%%%%%%%%                 %%
%% %%%%%%%%%%%%%%%%%%% %%%%%%%%%%%%%%%     %%%%%%%%%%%                 %%
%% %%%%%%%%%%%%%%%%%%% %%%%%%%%%%%%%%%     %%%%%%%%%%%                 %%
%% %%%%%%%%%%%%%%%%%%% %%%%%%%%%%%%%%%     %%%%%%%%%%%                 %%
%% %%%%%%%%%%%%%%%%%%% %%%%%%%%%%%%%%%     %%%%%%%%%%%                 %%
%% %%%%%%%%%%%%%%%%%%% %%%%%%%%%%%%%%%     %%%%%%%%%%%                 %%
%%%%%%%%%%%%%%%%%%%%%%%%%%%%%%%%%%%%%%     %%%%%%%%%%%%%%%%%%%%%%%%%%%%%%
%% %%%%%%%%%%%%%%%%%%%%%%%%%%%%%%%%%%%     %%%%%%%%%%%%%%%%%%%%%%%%%%%%%%
%% %%%%%%%%%%%%%%%%%%%%%%%%%%%%%%%%%%%%%%% %%%%%%%%%%%%%%%%%%%%%%%%%%%%%%
%%%%%%%%%%%%%%%%%%%%%%%%%%%%%%%%%%%%%%%%%% %%%%%%%%%%%%%%%%%%%%%%%%%%%%%%
%%%%%%%%%%%%%%%%%%%%%%%%%%%%%%%%%%%%%%%%%% %%%%%%%%%%%%%%%%%%%%%%%%%%%%%%
%%%%%%%%%%%%%%%%%%%%%%%%%%%%%%%%%%%%%%%%%% %%%%%%%%%%%%%%%%%%%%%%%%%%%%%%
%%%%%%%%%%%%%%%%%%%%%%%%%%%%%%%%%%%%%%%%%% %%  %%%%%%%%%%%%%%%%%%%%%%%%%%
%%       %%%%%%%%%%%%%%%%%%%%%%%%%%%%%%%%% %%  %%%%%%%%%%%%%%%%%%%%%%%%%%
%%       %%%%%%%%%%%%%%%%%%%%%%%%%%%%%%%%% %%%%%%%%%%%%%%%%%%%%%%%%%%%%%%
%%%%%%%%%%%%%%%%%%%%%%%%%%%%%%%%%%%%%%%%%%%%%%%%%%%%%%%%%%%%%%%%%%%%%%%%%
%%%%%%%%%%%%%%%%%%%%%%%%%%%%%%%%%%%%%%%%%%%%%%%%%%%%%%%%%%%%%%%%%%%%%%%%%
%%%%%%%%%%%%%%%%%%%%%%%%%%%%%%%%%%%%%%%%%%     %%%%%%%%%%%%%%%%%%%%%%%%%%
%%%%%%%%%%%%%%%%%%%%%%%%%%%%%%%%%%%%%%%%%%     %%%%%%%%%%%%%%%%%%%%%%%%%%
%%%%%%%%%%%%%%%%%%%%%%%%%%%%%%%%%%%%%%%%%%%%%%%%%%%%%%%%%%%%%%%%%%%%%%%%%
%%       %%        %%%%%%%%%%%%%%%%%%%%%%%     %%%%%%%%%%%%%%%%%%%%%%%%%%
%%       %%   .    %%%%%%%%%%%%%%%%%%%%%%%     %%%%%                   %%
%%%%%%%%%%%%%%%%%%%%%%%%%%%%%%%%%%%%%%%%%%     %%%%%                   %%
%%%%%%%%%%%%%%%%%%%%%%%%%%%%%%%%%%%%%%%%%%     %%%%%                   %%
%%       %%%%%%%%%%%%%%%%%%%%%%%%%%%%%%%%%     %%%%%                   %%
%%%%%%%%%%%%%%%%%%%%%%%%%%%%%%%%%%%%%%%%%%%%%%%%%%%%                   %%
%%%%%%%%%%%%%%%%%%%%%%%%%%%%%%%%%%%%%%%%%%%%%%%%%%%%                   %%
%%       %%%%%%%%%%%%%%%%%%%%%%%%%%%%%%%%%     %%%                     %%
%%       %%%%%%%%%%%%%%%%%%%%%%%%%%%%%%%%%     %%%%%%%%%%%%%%%         %%
%%       %%%%%%%%%%%%%%%%%%%%%%%%%%%%%%%%%     %%%%%%%%%%%%%%%         %%
%%       %%%%%%%%%%%%%%%%%%%%%%%%%%%%%%%%%     %%%%%%%%%%%%%%%         %%
%%       %%%%%%%%%%%%%%%%%%%%%%%%%%%%%%%%%     %%%%%%%%%%%%%%%         %%
%%       %%%%%%%%%%%%%%%%%%%%%%%%%%%%%%%%%     %%%%%%%%%%%%%%%         %%
%%%%%%%%%%%%%%%%%%%%%%%%%%%%%%%%%%%%%%%%%%     %%%%%%%%%%%%%%%         %%
%%%%%%%%%%%%%%%%%%%%%%%%%%%%%%%%%%%%%%%%%%     %%%%%%%%%%%%%%%         %%
%%                                     %%%     %%%%%%%%%%%%%%%         %%
%%                                     %%%%%%%%%%%%%%%%%%%%%%%         %%
%%                                     %%%%%%%%%%%%%%%%%%%%%%%         %%
%%%%%%%%%%%%%%%%%%%%%%%%%%%%%%%%%%%%%%%%%%%%%%%%%%%%%%%%%%%%%%%%%%%%%%%%%
%%%%%%%%%%%%%%%%%%%%%%%%%%%%%%%%%%%%%%%%%%%%%%%%%%%%%%%%%%%%%%%%%%%%%%%%%
%%%%%%%%%%%%%%%%%%%%%%%%%%%%%%%%%%%%%%%%%%%%%%%%%%%%%%%%%%%%%%%%%%%%%%%%%
%%%%%%%%%%%%%%%%%%%%%%%%%%%%%%%%%%%%%%%%%%%%%%%%%%%%%%%%%%%%%%%%%%%%%%%%%
%%%%%%%%%%%%%%%%%%%%%%%%%%%%%%%%%%%%%%%%%%%%%%%%%%%%%%%%%%%%%%%%%%%%%%%%%
%%%%%%%%%%%%%%%%%%%%%%%%%%%%%%%%%%%%%%%%%%%%%%%%%%%%%%%%%%%%%%%%%%%%%%%%%
#
