%%%%%%%%%%%%%%%%%%%%%%%%%%%%%%%%
%%%%%%%%%%%%%%%%%%%%%%%%%%%%%%%%
%%%%%%%%%%%%%%%%%%%%%%%%%%%%%%%%
%%%%%% %%%%%%%%%%%%%%%%%%%% %%%%
%%%%%%   %         %%%%%%%% %%%%
%%%%%% %%%%%%%%%%%%%%%%%%%% %%%%
%%%%%%%%%%%%%%%%%%%%%%%%%%% %%%%
%%%%%%%%%%%%%%%%%%%%%%%%%%% %%%%
%%%%%%%%%%%%% %%%%%%%%%%%%% %%%%
%%%%     %    %%%%%%%%%%%%% %%%%
%%%%%%%%%%%%%%%%%%%%%%%%%%%%%%%%
%%%%%%%%%%%%%%%%%%%%%%%%%%%%%%%%
%%%%%%%%%%%%%%%%%%%%%%%%%%%%%%%%
%%%%%%%%%%%%%%%%%%%%%%%%%%%%%%%%
%%%%%  %%%%%%%%%%%%%%%%%%%%%%%%%
%%%%% %%%%%%%%%%%%%%%%%%%%% %%%%
%%%%%  %%%%%%%%%%%%%%%%%%%%%%%%%
%%%%%  %%%%%%%       %%%%%% %%%%
%%%%%..%%%%%%%       %%%%%% %%%%
%%%%%%%%%%%%%%%%%%%%%%%%%%% %%%%
%%%%%%%%%%%%%%%%%%%%%%%%%%% %%%%
%%%%%%%%%%%%%%%%%%%%%%%%%%%%%%%%
%%%%     %       %%%%%%%%%%%%%%%
%%%%     %       %%%%%%%%%%%%%%%
%%%%     %       %%%%%%%...%%%%%
%%%%     %       %%%%%%%...%%%%%
%%%%     %       %%%%%%%...%%%%%
%%%%     %       %%%%%%%%%%%%%%%
%%%%     %       %%%%%%%%%%%%%%%
%%%%%%%%%%%%%%%%%%%%%%%%%%%%%%%%
%%%%%%%%%%%%%%%%%%%%%%%%%%%%%%%%
#
%%%%%%%%%%%%%%%%%%%%%%%%%%%%%%%%
%%%%%%%%%%%%%%%%%%%%%%%%%%%%%%%%
%%%%%%%%%%%%%%%%%%%%%%%%%%%   %%
%%%%       %%%%%%%%%%%%%%%%%  %%
%%%%P      %%%%%%%%% %%%%%%%  %%
%%%%       %%%%%%%%% %%%%%%%  %%
%%%%%%%%%%%%%%%%%%%%%%%%%%%%  %%
%%%%%%%%%%%%%%%%%%%%%%%%%%%%  %%
%%%%%%%%%%%%    %%%%%%%%%%%%  %%
%%              %%%%%%%%%%%%  %%
%%  %%%%%%%%%%%%%%%%%%%%%%%%  %%
%%  %%%%%%%%%%%%%%%%%%%%%%%%  %%
%%  %%%%%%%%%%%%%%%%%% %%%%%  %%
%%  %%%%%%%%%%%%%%%%%%  %%%%  %%
%%    %%%%%%%%%%%%%%%%%%%%%%  %%
%%    %%%%%%%%%%%%%%%%%%%%%%  %%
%%  %%%%%%%%%%%%%%%%%%%%%%    %%
%%  %%%%%%%%          %%%%    %%
%%  %%%%%%%%          %%%%    %%
%%  %%%%%%%%%%%%%%%%%%%%%%    %%
%%  %%%%%%%%%%%%%%%%%%%%%%    %%
%%  %%%%%%%%%%%%%%%%%%%%%%%%%%%%
%%                 %%%%%%%%%%%%%
%%                 %%%%%%%%%%%%%
%%                 %%%  ...  %%%
%%                 %%%  ...  %%%
%%                 %%%  ...  %%%
%%                 %%%%%%%%%%%%%
%%                 %%%%%%%%%%%%%
%%%%%%%%%%%%%%%%%%%%%%%%%%%%%%%%
%%%%%%%%%%%%%%%%%%%%%%%%%%%%%%%%
#
%%%%%%%%%%%%%%%%%%%%%%%%%%%%%%%%
%%%%%%%%%%%%%%%%%%%%%%%%%%%%%%%%
%%%%%%%%%%%%%%%%%%%%%%%%%%%%%%%%
%%%%%%%%%%%%%%%%%%%%%%%%%%%%%%%%
%%%%%%%%%%%%%%%%%%%%%%%%%%%%  %%
%%%%%%%%%%%%%%%%%%%%%%%%%%%%  %%
%%%%%%%%%%%%%%%%%%%%%%%%%%%%  %%
%%%%%%%%%%%%%%%%%%%%%%%%%%%%  %%
%%%%%%%%%%%%%%%%%%%%%%%%%%%%  %%
%%%%%%%%%%%%%%%%%%%%%%%%%%%%  %%
%%%%%%%%%%%%%%%%%%%%%%%%%%%%  %%
%%  %%%%%%%%%%%%%%%%%%%%%%%%  %%
%%  %%%%%%%%%%%%%%%%%%%%%%%%  %%
%%%%%%%%%%%%%%%%%%%%%%%%%%%%  %%
%%%%%%%%%%%%%%%%%%%%%%%%%%%%  %%
%%%%%%%%%%%%%%%%%%%%%%%%%%%%  %%
%%%%%%%%%%%%%%%%%%%%%% %%%%%  %%
%%%%%%%%%%%%%%%%%%%%%% %%%%%  %%
%%%%%%%%%%%%%%%%%%%%%%%%%%%%  %%
%%%%%%%%%%%%%%%%%%%%%%%%%%%%%%%%
%%  %%%%%%%%%%%%%%%%%% %%%%%%%%%
%%  %%%%%%%%%%%%%%%%%% %%%%%%%%%
%%%%%%%%%%%%%%%%%%%%%% %%%%%%%%%
%%%%%%%%%%%%%%%%%%%%%% %%%%%%%%%
%%                 %%% %%%%%%%%%
%%                 %%%%%%%%%%%%%
%%                 %%%%%%%%%%%%%
%%%%%%%%%%%%%%%%%%%%%%%%%%%%%%%%
%%%%%%%%%%%%%%%%%%%%%%%%%%%%%%%%
%%%%%%%%%%%%%%%%%%%%%%%%%%%%%%%%
%%%%%%%%%%%%%%%%%%%%%%%%%%%%%%%%
#
