%%%%%%%%%%%%%%%%%%%%%%%%%%%%%%%%%%%%%%%%%%%%%
%%%%%%%%%%%%%%%%%%%%%%%%%%%%%%%%%%%%%%%%%%%%%
%%%%%%               %%%%%%%%%%%%%%%%%%%%%%%%
%%%%%%               %%%%%%%%%%%%%%%%%%%%%%%%
%%%%%%       %%%%%%%%%%%%%%%%%%%%%   %%%%%%%%
%%%%%%       %%%%%%%%%%%%%%%%%%%%%   %%%%%%%%
%%%%%%       %%%%%%%%%%%%%%%%%%%%%   %%%%%%%%
%%%%%%       %%%%%%%%%%%.....        %%%%%%%%
%%%%%%       %%%%%%%%%%%......       %%%%%%%%
%%%%%%       %%%%%%%%%%%.....        %%%%%%%%
%%%%%%       %%%%%%%%%%%%%%%%%%%%%   %%%%%%%%
%%%%%%       %%%%%%%%%%%%%%%%%%%%%   %%%%%%%%
%%%%%%       %%%%%%%%%%%%%%%%%%%%%   %%%%%%%%
%%%%%%               %%%%%%%%%%%%%%%%%%%%%%%%
%%%%%%               %%%%%%%%%%%%%%%%%%%%%%%%
%%%%%%               %%%%%%%%%%%%%%%%%%%%%%%%
%%%%%%                 %%%    %%%    %%%%%%%%
%%%%%%%%%%%%%%%%%%%%%%%%%%    %%%%   %%%%%%%%
%%%%%%%%%%%%%%%%%%%%%%%%%%%%% %%%%   %%%%%%%%
%%%%%%%%%%%%%%%%%%%%%%%%%%%%% %%%%   %%%%%%%%
%%%%%%         %%%  %%%%%%%%% %%%%   %%%%%%%%
%%%%%%         %%%  %%%%%%%%% %%%%   %%%%%%%%
%%%%%%         %%%     %%%    %%%%   %%%%%%%%
%%%%%%                 %             %%%%%%%%
%%%%%%                 %             %%%%%%%%
%%%%%%                 %             %%%%%%%%
%%%%%%                 %             %%%%%%%%
%%%%%%         %%%     %%%%%%%%%%%%%%%%%%%%%%
%%%%%%         %%%     %%%%%%%%%%%%%%%%%%%%%%
%%%%%%%%%%%%%%%%%%%%%%%%%%%%%%%%%%%%%%%%%%%%%
%%%%%%%%%%%%%%%%%%%%%%%%%%     %%%     %%%%%%
%%%%%%%%%%%%%%%%%%%%%%%%%%     %%%     %%%%%%
%%%%%%                 %               %%%%%%
%%%%%%                 %               %%%%%%
%%%%%%                 %               %%%%%%
%%%%%%                 %               %%%%%%
%%%%%%                 %               %%%%%%
%%%%%%                 %               %%%%%%
%%%%%%                 %               %%%%%%
%%%%%%%%%%%%%%%%%%%%%%%%%%%%%%%%%%%%%%%%%%%%%
%%%%%%%%%%%%%%%%%%%%%%%%%%%%%%%%%%%%%%%%%%%%%
#
%%%%%%%%%%%%%%%%%%%%%%%%%%%%%%%%%%%%%%%%%%%%%
%%%%%%%%%%%%%%%%%%%%%%%%%%%%%%%%%%%%%%%%%%%%%
%%%%%%%%%%%%%%%%%%%%%%%%%%%%%%%%%%%%%%%%%%%%%
%%%%%%%%%%%%%%%%%%%%%%%%%%%%%%%%%%%%%%%%%%%%%
%%%%           %%%%%%%%%%%%%%%%%%%%%%%%%%%%%%
%%%%           %%%%%%%%%%%%%%%%%%%%%%%%%%%%%%
%%%%           %%%%%%%%%%%%%%%         %%%%%%
%%%%           %%%%%%%%%%%%%%          %%%%%%
%%%%           %%%%%%%%%%%%%           %%%%%%
%%%%           %%%%%%%%%%%%%%          %%%%%%
%%%%           %%%%%%%%%%%%%%%         %%%%%%
%%%%           %%%%%%%%%%%%%%%%%%%%%%  %%%%%%
%%%%           %%%%%%%%%%%%%%%%%%%%%%% %%%%%%
%%%%            %%%%%%%%%%%%%%%%%%%%%%%%%%%%%
%%%%             %%%%%%%%%%%%%%%%%%%%%%%%%%%%
%%%%%%%%%%%%%%%%%%%%%%%%%%%%%%%%%%%%%%%%%%%%%
%%%%%%%%%%%%%%%%%%%%%%%%%%%%%%%%%%%%%%%%%%%%%
%%%%%%%%%%%%%%%%%%%%%%%%%%%%%%%%%%%%%%%%%%%%%
%%%%%%%%%%%%%%%%%%%%%%%%%%%%%%%%%%%%%%%%%%%%%
%%%%%%%%%%%%%%%%%%%%%%%%%%%%%%%%%%%%%%%%%%%%%
%%%%%%%%%%%%%%%%%%%%%%%%%%%%%%%%%%%%%%%%%%%%%
%%%%%%%%%%%%%%%%%%%%%%%%%%%%%%%%%%%    %%%%%%
%%%%                 %%%%%%% %%%%%%    %%%%%%
%%%%                 %%%%%%% %%%%%%    %%%%%%
%%%%  P              %%%%%%% %%%%%%    %%%%%%
%%%%                 %%%%%%%%%%%%%%%%%%%%%%%%
%%%%                 %%%%%%%%%%%%%%%%%%%%%%%%
%%%%%%%%%%%%%%%%%%%%%%%%%%%%%%%%%%%%%%%%%%%%%
%%%%%%%%%%%%%%%%%%%%%%%%%%%%%%%%%%%%%%%%%%%%%
%%%%%%%%%%%%%%%%%%%%%%%%%%%%%%%%%%%%%%%%%%%%%
%%%%%%%%%%%%%%%%%%%%%%%%%%%%%%%%%%%%%%%%%%%%%
%%%%%%%%%%%%%%%%%%%%%%%%%%%%%%%%%%%%%%%%%%%%%
%%%%%%%%%%%%%%%%%%%%%%%%%%%%             %%%%
%%%%%%%%%%%%%%%%%%%%%%%%%%%%             %%%%
%%%%                                     %%%%
%%%%                                     %%%%
%%%%                                     %%%%
%%%%%%%%%%%%%%%%%%%%%%%%%%%%%%%%%%%%%%%%%%%%%
%%%%%%%%%%%%%%%%%%%%%%%%%%%%%%%%%%%%%%%%%%%%%
%%%%%%%%%%%%%%%%%%%%%%%%%%%%%%%%%%%%%%%%%%%%%
%%%%%%%%%%%%%%%%%%%%%%%%%%%%%%%%%%%%%%%%%%%%%
#
%%%%%%%%%%%%%%%%%%%%%%%%%%%%%%%%%%%%%%%%%%%%%
%%%%%%%%%%%%%%%%%%%%%%%%%%%%%%%%%%%%%%%%%%%%%
%%%%%%%%%%%%%%%%%%%%%%%%%%%%%%%%%%%%%%%%%%%%%
%%%%%%%%%%%%%%%%%%%%%%%%%%%%%%%%%%%%%%%%%%%%%
%%%%%%%%%%%%%%%%%%%%%%%%%%%%%%%%%%%%%%%%%%%%%
%%%%%%%%%%%%%%%%%%%%%%%%%%%%%%%%%%%%%%%%%%%%%
%%%%%%%%%%%%%%%%%%%%%%%%%%%%%%%%%%%%%%%%%%%%%
%%               %%%%%%%%%%%%%%%%%%%%%%%%%%%%
%%               %%%%%%%%%%%%%           %%%%
%%%%%%%%%%%%%%%%%%%%%%%%%%%%%%%%%%%%%    %%%%
%%%%%%%%%%%%%%%%%%%%%%%%%%%%%%%%%%%%%    %%%%
%%               %%%%%%%%%%%%%%%%%%%%    %%%%
%%               %%%%%%%%%%%%%%%%%%%%    %%%%
%%%%%%%%%%%%%%%%%%%%%%%%%%%%%%%%%%%%%    %%%%
%%%%%%%%%%%%%%%%%%%%%%%%%%%%%%%%%%%%%    %%%%
%%%%%%%%%%%%%%%%%%%%%%%%%%%%%%%%%%%%%    %%%%
%%%%%%%%%%%%%%%%%%%%%%%%%%%%%%%%%%%%%    %%%%
%%%%%%%%%%%%%%%%%%%%%%%%%%%%%%%%%%%%%    %%%%
%%%%%%%%%%%%%%%%%%%%%%%%%%%%%%%%%%%%%    %%%%
%%%%%%%%%%%%%%%%%%%%%%%%%%%%%%%%%%%%%    %%%%
%%%%%%%%%%%%%%%%%%%%%%%%%%%%%%     %%    %%%%
%%%%%%%%%%%%%%%%%%%%%%%%%%%%%%     %%    %%%%
%%%%%%%%%%%%%%%%%%%%%%%%%%%%%%     %%    %%%%
%%%%%%%%%%%%%%%%%%%%%%%%%%%%%%%%%%%%%%%%%%%%%
%%                 %%%%%%%%%%%%%%%%%%%%%%%%%%
%%%%%%%%%%%%%%%%%%%%%%%%%%%%%%%%%%%%%%%%%%%%%
%%%%%%%%%%%%%%%%%%%%%%%%%%%%%%%%%%%%%%%%%%%%%
%%%%%%%%%%%%%%%%%%%%%%     %%%%%%%%%%%%%%%%%%
%%%%%%%%%%%%%%%%%%%%%%     %%%%%%%%%%%%%%%%%%
%%%%%%%%%%%%%%%%%%%%%%     %%%%%%%%%%%%%%%%%%
%%%%%%%%%%%%%%%%%%%%%%     %%%%%%%%%%%%%%%%%%
%%%%%%%%%%%%%%%%%%%%%%     %%%%%%%%%%%%%%%%%%
%%%%%%%%%%%%%%%%%%%%%%%%%%%%%%%%%%%%%%%%%%%%%
%%%%%%%%%%%%%%%%%%%%%%%%%%%%%%%%%%%%%%%%%%%%%
%%%%%%%%%%%%%%%%%%%%%%%%%%%%%%             %%
%%%%%%%%%%%%%%%%%%%%%%%%%%%%%%%%%%%%%%%%%%%%%
%%%%%%%%%%%%%%%%%%%%%%%%%%%%%%%%%%%%%%%%%%%%%
%%%%%%%%%%%%%%%%%%%%%%%%%%%%%%%%%%%%%%%%%%%%%
%%%%%%%%%%%%%%%%%%%%%%%%%%%%%%%%%%%%%%%%%%%%%
%%%%%%%%%%%%%%%%%%%%%%%%%%%%%%%%%%%%%%%%%%%%%
%%%%%%%%%%%%%%%%%%%%%%%%%%%%%%%%%%%%%%%%%%%%%
#
